##################
#        P       #
#                #
#                #
#       O        #
#                #
#                #
#                #
#                #
#                #
#                #
#                #
#                #
#        X       #
#  O             #
#                #
#                #
##################
