############
#        O #
#     P ####
#          #
#######    #
#  O ##    #
#    ##    #
#          #
#       XX #
#       #  #
####### ####
