############
#        O #
#  P    ####
#          #
#######    #
#    ##    #
#    ##    #
#          #
#       XX #
#        # #
############
